climbSta|climbStairs|tsserver-javascript
deviceIn|deviceInformation|tsserver-typescript
androidInf|androidInfo|around
androidI|androidInfo|around
deviceInfo|deviceInformation|tsserver-typescript
reves|reverse|tsserver-javascript
hard|hardware|around
androi|androidInfo|around
setG|setRumGlobalContext|tsserver-typescript
datadogR|datadogRum|tsserver-typescript
platformI|platformInfo|around
nativeAppCon|nativeAppConfig|tsserver-typescript
trackFru|trackFrustrations?|tsserver-typescript
trackInte|trackInteractions?|tsserver-typescript
pre|premiumSampleRate?|tsserver-typescript
LIS|LIST_OF_BUCKETS|around
clou|cloudwatch_log_group_kms_arn|buffer
07|07-clean-up.sh|file
06|06-set-kms-in-log-groups.sh|file
05|05-get-log-groups.sh|file
04-|04-update-permission.sh|file
02|02-create-key.sh|file
|01-check-region.sh|file
is_connec|is_connections_team_homepage|around
is_conne|is_connection_team_homepage|around
find|find_by_id|around
find|find_by_name|buffer
find_by_|find_by_name|buffer
uuid|uuid4|buffer
find_by|find_by_name|around
maybe_upda|maybe_update_won_state|buffer
current_|current_max|around
current_|current_number|around
find|find_by_name|around
maybe_up|maybe_update_maximums|buffer
find_|find_by_name|around
curren|current_max|around
find_last_message|find_last_message_username|buffer
cur|current_max|around
last_u|last_user|around
fetchP|fetchPNows|tsserver-javascript
fetP|fetchPNows|tsserver-javascript
pNow|pNows|tsserver-javascript
ASAN|ASANA_API_KEY|tsserver-javascript
getPN|getPNows|tsserver-javascript
fetchPN|fetchPNows|around
getP|getPNows|tsserver-javascript
write|writeFileSync|tsserver-javascript
asanaPN|asanaPNowString|tsserver-javascript
taskDe|taskDetails|tsserver-javascript
fetch|fetchAsanaPNow|tsserver-javascript
asanaPNowM|asanaPNowMonitors|tsserver-javascript
as|assignee|tsserver-javascript
asanaP|asanaPNow|tsserver-javascript
asana|asanaPNow|around
assi|assignee|buffer
taskDetail|taskDetail|tsserver-javascript
useAcces|useAccessToken|tsserver-javascript
put_l|put_locale|buffer
Th|ThousandWeb|around
Thousan|ThousandWeb|around
thousand_|thousand_web|buffer
thous|thousand|around
consec|consecutive|buffer
new|newgame|around
|server|file
set_se|set_secret_key_base.sh|file
id_rsa|id_rsa|file